Rk,Player,Pos,Age,Tm,G,GS,MP,FG,FGA,FG.,X3P,X3PA,X3P.1,X2P,X2PA,X2P.1,eFG.,FT,FTA,FT.,ORB,DRB,TRB,AST,STL,BLK,TOV,PF,PTS
1,Quincy Acy,PF,25,SAC,23,7,258,33,58,0.569,4,8,0.5,29,50,0.58,0.603,16,22,0.727,22,36,58,9,10,8,7,30,86
2,Jordan Adams,SG,21,MEM,2,0,15,2,6,0.333,0,1,0,2,5,0.4,0.333,3,5,0.6,0,2,2,3,3,0,2,2,7
3,Steven Adams,C,22,OKC,45,45,1104,127,215,0.591,0,0,,127,215,0.591,0.591,66,106,0.623,116,171,287,31,19,53,41,125,320
4,Arron Afflalo,SG,30,NYK,39,39,1294,215,473,0.455,50,137,0.365,165,336,0.491,0.507,64,73,0.877,13,131,144,71,12,8,39,92,544
5,Alexis Ajinca,C,27,NOP,34,6,413,73,139,0.525,0,1,0,73,138,0.529,0.525,18,19,0.947,39,96,135,15,9,17,17,74,164
6,Cole Aldrich,C,27,LAC,23,2,266,53,101,0.525,0,0,,53,101,0.525,0.525,29,42,0.69,24,62,86,20,16,15,19,47,135
7,LaMarcus Aldridge,PF,30,SAS,41,41,1207,266,551,0.483,0,11,0,266,540,0.493,0.483,109,136,0.801,104,254,358,54,13,38,58,87,641
8,Cliff Alexander,PF,20,POR,7,0,31,5,10,0.5,0,0,,5,10,0.5,0.5,0,0,,2,4,6,0,1,2,1,0,10
9,Lavoy Allen,PF,26,IND,44,21,958,112,229,0.489,0,0,,112,229,0.489,0.489,16,28,0.571,89,147,236,47,19,23,45,79,240
10,Tony Allen,SF,34,MEM,39,32,957,106,252,0.421,9,24,0.375,97,228,0.425,0.438,36,64,0.563,67,115,182,39,67,10,41,113,257
11,Al-Farouq Aminu,SF,25,POR,47,46,1360,176,431,0.408,69,199,0.347,107,232,0.461,0.488,68,93,0.731,55,247,302,72,40,33,78,105,489
12,Lou Amundson,PF,33,NYK,18,0,139,16,35,0.457,0,0,,16,35,0.457,0.457,9,18,0.5,13,23,36,7,5,3,6,31,41
13,Chris Andersen,C,37,MIA,7,1,36,4,10,0.4,2,5,0.4,2,5,0.4,0.5,3,4,0.75,3,6,9,3,1,3,2,4,13
14,James Anderson,SG,26,SAC,24,6,240,15,56,0.268,9,28,0.321,6,28,0.214,0.348,9,10,0.9,6,22,28,14,5,3,13,20,48
15,Justin Anderson,SG,22,DAL,25,1,189,20,57,0.351,6,31,0.194,14,26,0.538,0.404,7,12,0.583,1,29,30,8,7,4,10,15,53
16,Kyle Anderson,SF,22,SAS,42,2,517,59,120,0.492,5,15,0.333,54,105,0.514,0.513,31,44,0.705,11,81,92,47,18,16,24,41,154
17,Ryan Anderson,PF,27,NOP,42,6,1321,250,577,0.433,89,226,0.394,161,351,0.459,0.51,123,140,0.879,85,169,254,41,25,18,66,68,712
18,Giannis Antetokounmpo,SF,21,MIL,45,44,1539,270,528,0.511,13,57,0.228,257,471,0.546,0.524,156,202,0.772,66,258,324,124,44,52,112,158,709
19,Carmelo Anthony,SF,31,NYK,42,42,1455,320,739,0.433,57,172,0.331,263,567,0.464,0.472,197,241,0.817,63,251,314,169,36,22,104,101,894
20,Joel Anthony,C,33,DET,12,0,50,2,5,0.4,0,0,,2,5,0.4,0.4,5,6,0.833,6,8,14,1,2,4,1,7,9
21,Keith Appling,PG,23,ORL,2,0,15,2,6,0.333,0,1,0,2,5,0.4,0.333,2,2,1,0,1,1,0,1,0,2,3,6
22,Trevor Ariza,SF,30,HOU,46,46,1586,201,484,0.415,105,277,0.379,96,207,0.464,0.524,60,82,0.732,33,181,214,87,83,11,65,102,567
23,Darrell Arthur,PF,27,DEN,42,10,885,134,288,0.465,17,42,0.405,117,246,0.476,0.495,20,25,0.8,51,119,170,50,36,30,37,107,305
24,Omer Asik,C,29,NOP,37,33,613,43,85,0.506,0,0,,43,85,0.506,0.506,39,62,0.629,62,137,199,14,10,14,35,71,125
25,D.J. Augustin,PG,28,OKC,32,0,494,44,117,0.376,23,60,0.383,21,57,0.368,0.474,26,34,0.765,5,31,36,61,13,2,29,37,137
26,Jeff Ayres,C,28,LAC,1,0,5,0,0,,0,0,,0,0,,,2,2,1,0,1,1,1,0,0,0,0,2
27,Luke Babbitt,SF,26,NOP,22,5,301,27,73,0.37,16,51,0.314,11,22,0.5,0.479,8,11,0.727,5,48,53,10,1,3,5,37,78
28,Cameron Bairstow,C,25,CHI,9,0,34,4,15,0.267,0,2,0,4,13,0.308,0.267,0,0,,4,8,12,0,1,1,1,6,8
29,Leandro Barbosa,SG,33,GSW,32,0,468,83,186,0.446,20,54,0.37,63,132,0.477,0.5,21,25,0.84,11,34,45,46,28,5,33,53,207
30,J.J. Barea,PG,31,DAL,41,8,884,149,358,0.416,48,138,0.348,101,220,0.459,0.483,43,55,0.782,15,66,81,164,16,2,67,61,389
31,Andrea Bargnani,C,30,BRK,40,0,557,115,251,0.458,3,16,0.188,112,235,0.477,0.464,43,53,0.811,25,58,83,13,4,8,25,54,276
32,Harrison Barnes,SF,23,GSW,29,22,835,133,284,0.468,32,84,0.381,101,200,0.505,0.525,53,63,0.841,30,103,133,54,24,5,29,60,351
33,Matt Barnes,SF,35,MEM,43,18,1142,137,336,0.408,60,182,0.33,77,154,0.5,0.497,50,61,0.82,49,171,220,74,49,30,53,131,384
34,Will Barton,SG,25,DEN,45,1,1313,253,574,0.441,73,191,0.382,180,383,0.47,0.504,120,140,0.857,42,233,275,109,41,18,70,79,699
35,Brandon Bass,PF,30,LAL,39,0,697,95,170,0.559,0,1,0,95,169,0.562,0.559,56,66,0.848,60,102,162,43,19,34,22,68,246
36,Nicolas Batum,SG,27,CHO,37,37,1289,191,460,0.415,75,214,0.35,116,246,0.472,0.497,103,122,0.844,35,197,232,201,34,18,114,65,560
37,Jerryd Bayless,SG,27,MIL,29,7,829,108,256,0.422,58,136,0.426,50,120,0.417,0.535,37,48,0.771,12,68,80,101,29,5,52,65,311
38,Aron Baynes,C,29,DET,44,0,627,96,194,0.495,0,1,0,96,193,0.497,0.495,49,67,0.731,71,125,196,32,10,23,39,81,241
39,Kent Bazemore,SF,26,ATL,41,34,1154,191,409,0.467,70,168,0.417,121,241,0.502,0.553,76,90,0.844,11,173,184,98,53,19,70,94,528
40,Bradley Beal,SG,22,WAS,22,17,724,151,338,0.447,46,115,0.4,105,223,0.471,0.515,59,77,0.766,21,72,93,67,23,6,57,52,407
41,Marco Belinelli,SG,29,SAC,45,1,1144,163,422,0.386,65,206,0.316,98,216,0.454,0.463,93,108,0.861,6,77,83,92,23,2,58,68,484
42,Anthony Bennett,PF,22,TOR,13,0,64,5,20,0.25,2,12,0.167,3,8,0.375,0.3,7,8,0.875,5,13,18,0,3,0,4,8,19
43,Patrick Beverley,PG,27,HOU,36,28,937,117,278,0.421,63,150,0.42,54,128,0.422,0.534,25,36,0.694,28,78,106,93,41,10,46,110,322
44,Bismack Biyombo,C,23,TOR,45,18,1023,83,163,0.509,0,0,,83,163,0.509,0.509,81,121,0.669,105,269,374,12,9,68,48,124,247
45,Nemanja Bjelica,PF,27,MIN,40,0,748,64,154,0.416,34,94,0.362,30,60,0.5,0.526,20,33,0.606,29,106,135,55,17,16,29,110,182
46,Tarik Black,C,24,LAL,14,0,157,23,38,0.605,0,0,,23,38,0.605,0.605,8,21,0.381,15,45,60,3,2,4,9,27,54
47,DeJuan Blair,C,26,WAS,26,0,205,28,66,0.424,0,1,0,28,65,0.431,0.424,5,11,0.455,20,34,54,10,8,2,15,48,61
48,Steve Blake,PG,35,DET,29,0,450,47,121,0.388,27,77,0.351,20,44,0.455,0.5,5,7,0.714,6,39,45,87,14,3,41,30,126
49,Eric Bledsoe,PG,26,PHO,31,31,1059,223,492,0.453,48,129,0.372,175,363,0.482,0.502,138,172,0.802,18,107,125,190,63,19,110,75,632
50,Bojan Bogdanovic,SF,26,BRK,46,17,1241,164,387,0.424,60,175,0.343,104,212,0.491,0.501,48,59,0.814,24,134,158,49,21,3,59,64,436
51,Andrew Bogut,C,31,GSW,38,34,792,100,156,0.641,0,0,,100,156,0.641,0.641,12,29,0.414,67,202,269,73,13,64,44,117,212
52,Matt Bonner,C,35,SAS,18,1,107,15,29,0.517,8,16,0.5,7,13,0.538,0.655,1,2,0.5,3,14,17,5,5,0,2,6,39
53,Devin Booker,SG,19,PHO,40,15,834,134,288,0.465,39,92,0.424,95,196,0.485,0.533,65,81,0.802,10,63,73,53,20,5,47,90,372
54,Trevor Booker,PF,28,UTA,42,2,965,94,218,0.431,5,22,0.227,89,196,0.454,0.443,44,61,0.721,112,167,279,40,39,20,54,105,237
55,Chris Bosh,PF,31,MIA,46,46,1546,314,659,0.476,73,196,0.372,241,463,0.521,0.532,183,230,0.796,43,307,350,113,34,32,65,82,884
56,Avery Bradley,SG,25,BOS,41,37,1329,237,541,0.438,81,222,0.365,156,319,0.489,0.513,50,65,0.769,26,80,106,87,65,10,62,85,605
57,Corey Brewer,SF,29,HOU,47,4,964,114,313,0.364,37,129,0.287,77,184,0.418,0.423,62,76,0.816,24,95,119,70,54,7,49,99,327
58,Aaron Brooks,PG,31,CHI,34,0,555,100,240,0.417,38,101,0.376,62,139,0.446,0.496,28,34,0.824,14,50,64,83,11,5,34,71,266
59,Anthony Brown,SF,23,LAL,22,6,401,27,85,0.318,14,48,0.292,13,37,0.351,0.4,12,15,0.8,7,40,47,8,9,4,13,22,80
60,Lorenzo Brown,PG,25,PHO,7,0,58,7,23,0.304,1,7,0.143,6,16,0.375,0.326,3,4,0.75,0,7,7,11,3,1,9,4,18
61,Markel Brown,SG,24,BRK,27,4,294,20,76,0.263,8,38,0.211,12,38,0.316,0.316,19,25,0.76,3,31,34,26,9,4,12,35,67
62,Kobe Bryant,SF,37,LAL,38,38,1107,210,606,0.347,62,249,0.249,148,357,0.415,0.398,120,153,0.784,25,124,149,132,34,8,87,74,602
63,Chase Budinger,SF,27,IND,39,2,625,66,164,0.402,18,61,0.295,48,103,0.466,0.457,31,44,0.705,23,76,99,43,21,7,25,37,181
64,Reggie Bullock,SF,24,DET,17,0,86,1,19,0.053,1,10,0.1,0,9,0,0.079,3,3,1,3,5,8,3,1,0,2,5,6
65,Trey Burke,PG,23,UTA,44,0,1082,214,499,0.429,65,186,0.349,149,313,0.476,0.494,51,65,0.785,15,75,90,120,28,5,60,59,544
66,Alec Burks,SG,24,UTA,28,3,760,133,325,0.409,29,75,0.387,104,250,0.416,0.454,106,141,0.752,16,84,100,59,16,4,49,69,401
67,Caron Butler,SF,35,SAC,9,1,86,11,26,0.423,1,8,0.125,10,18,0.556,0.442,1,2,0.5,3,8,11,3,5,0,2,7,24
68,Jimmy Butler,SG,26,CHI,44,44,1684,322,715,0.45,48,149,0.322,274,566,0.484,0.484,288,345,0.835,51,183,234,184,74,31,91,86,980
69,Rasual Butler,SF,36,SAS,29,0,270,31,68,0.456,11,34,0.324,20,34,0.588,0.537,8,11,0.727,0,36,36,17,7,15,5,6,81
70,Bruno Caboclo,SF,20,TOR,2,0,2,0,1,0,0,0,,0,1,0,0,0,0,,0,1,1,0,1,0,1,0,0
71,Jose Calderon,PG,34,NYK,47,47,1304,135,284,0.475,53,129,0.411,82,155,0.529,0.569,28,32,0.875,17,126,143,191,46,5,53,80,351
72,Kentavious Caldwell-Pope,SG,22,DET,45,45,1686,242,573,0.422,72,228,0.316,170,345,0.493,0.485,108,132,0.818,35,132,167,87,70,12,67,106,664
73,Isaiah Canaan,PG,24,PHI,45,24,1103,142,393,0.361,95,262,0.363,47,131,0.359,0.482,84,104,0.808,10,86,96,82,33,10,64,75,463
74,Clint Capela,C,21,HOU,46,35,992,149,260,0.573,0,0,,149,260,0.573,0.573,51,118,0.432,124,202,326,36,42,54,47,117,349
75,DeMarre Carroll,SF,29,TOR,23,22,735,99,255,0.388,42,111,0.378,57,144,0.396,0.471,28,48,0.583,28,82,110,24,38,5,27,57,268
76,Vince Carter,SG,39,MEM,28,0,359,32,106,0.302,14,58,0.241,18,48,0.375,0.368,18,21,0.857,8,39,47,20,12,9,12,45,96
77,Michael Carter-Williams,PG,24,MIL,42,32,1300,199,444,0.448,12,36,0.333,187,408,0.458,0.462,82,125,0.656,38,169,207,234,68,30,121,119,492
78,Omri Casspi,SF,27,SAC,40,18,1196,185,365,0.507,78,174,0.448,107,191,0.56,0.614,48,82,0.585,32,229,261,57,31,11,65,106,496
79,Willie Cauley-Stein,C,22,SAC,31,21,621,75,125,0.6,0,0,,75,125,0.6,0.6,32,59,0.542,66,112,178,13,21,38,19,74,182
80,Mario Chalmers,PG,29,MEM,37,5,832,115,270,0.426,34,99,0.343,81,171,0.474,0.489,134,165,0.812,13,79,92,141,49,6,72,112,398
81,Tyson Chandler,C,33,PHO,37,31,850,71,148,0.48,0,1,0,71,147,0.483,0.48,64,96,0.667,93,210,303,34,20,23,44,73,206
82,Ian Clark,SG,24,GSW,39,1,384,67,143,0.469,25,56,0.446,42,87,0.483,0.556,14,16,0.875,8,35,43,42,11,9,30,35,173
83,Jordan Clarkson,SG,23,LAL,45,45,1446,267,609,0.438,45,136,0.331,222,473,0.469,0.475,102,130,0.785,51,121,172,111,52,7,82,96,681
84,Norris Cole,PG,27,NOP,27,5,665,97,256,0.379,17,66,0.258,80,190,0.421,0.412,21,30,0.7,6,83,89,66,20,4,39,58,232
85,Darren Collison,PG,28,SAC,40,4,1143,183,403,0.454,44,117,0.376,139,286,0.486,0.509,95,114,0.833,15,72,87,168,37,1,75,73,505
86,Nick Collison,PF,35,OKC,39,2,483,32,75,0.427,0,2,0,32,73,0.438,0.427,19,27,0.704,49,70,119,32,11,10,28,77,83
87,Mike Conley,PG,28,MEM,40,40,1268,204,506,0.403,57,159,0.358,147,347,0.424,0.459,133,157,0.847,20,99,119,236,51,13,58,71,598
88,Pat Connaughton,SG,23,POR,19,0,57,4,20,0.2,2,9,0.222,2,11,0.182,0.25,2,2,1,5,9,14,2,2,0,6,3,12
89,Chris Copeland,PF,31,MIL,22,1,147,17,48,0.354,10,33,0.303,7,15,0.467,0.458,4,5,0.8,1,9,10,10,2,0,5,15,48
90,Bryce Cotton,PG,23,PHO,3,0,33,2,8,0.25,0,3,0,2,5,0.4,0.25,0,0,,0,0,0,3,3,0,5,2,4
91,DeMarcus Cousins,C,25,SAC,37,37,1257,342,760,0.45,44,129,0.341,298,631,0.472,0.479,281,383,0.734,90,326,416,104,48,47,132,143,1009
92,Robert Covington,SF,25,PHI,37,23,982,138,365,0.378,82,237,0.346,56,128,0.438,0.49,67,85,0.788,31,175,206,57,58,22,89,126,425
93,Allen Crabbe,SG,23,POR,47,9,1225,202,432,0.468,68,177,0.384,134,255,0.525,0.546,48,57,0.842,12,112,124,58,39,6,41,120,520
94,Jamal Crawford,SG,35,LAC,45,3,1141,185,478,0.387,56,174,0.322,129,304,0.424,0.446,127,138,0.92,9,66,75,92,21,6,61,70,553
95,Jae Crowder,SF,25,BOS,46,46,1490,230,508,0.453,81,221,0.367,149,287,0.519,0.532,125,152,0.822,49,187,236,86,83,24,63,118,666
96,Dante Cunningham,SF,28,NOP,42,12,827,71,164,0.433,27,77,0.351,44,87,0.506,0.515,13,20,0.65,26,107,133,23,21,18,14,80,182
97,Jared Cunningham,SG,24,CLE,34,3,342,32,89,0.36,10,30,0.333,22,59,0.373,0.416,30,48,0.625,3,26,29,19,11,2,16,36,104
98,Seth Curry,PG,25,SAC,23,0,244,27,61,0.443,12,29,0.414,15,32,0.469,0.541,19,23,0.826,3,16,19,18,8,0,12,14,85
99,Stephen Curry,PG,27,GSW,43,43,1453,430,839,0.513,210,461,0.456,220,378,0.582,0.638,231,253,0.913,33,196,229,280,92,6,142,86,1301
100,Troy Daniels,SG,24,CHO,23,0,241,45,95,0.474,33,63,0.524,12,32,0.375,0.647,3,6,0.5,5,25,30,8,6,1,9,22,126
101,Anthony Davis,PF,22,NOP,39,39,1376,338,687,0.492,19,66,0.288,319,621,0.514,0.506,200,261,0.766,79,317,396,69,50,94,84,94,895
102,Ed Davis,PF,26,POR,46,0,973,124,199,0.623,0,0,,124,199,0.623,0.623,67,126,0.532,135,199,334,52,28,34,35,118,315
103,Branden Dawson,PF,22,LAC,2,0,13,1,3,0.333,0,0,,1,3,0.333,0.333,0,0,,2,1,3,0,0,1,0,2,2
104,Dewayne Dedmon,C,26,ORL,27,4,308,32,64,0.5,0,0,,32,64,0.5,0.5,22,31,0.71,23,66,89,3,10,25,13,55,86
105,Bryce Dejean-Jones,SG,23,NOP,3,0,8,1,2,0.5,1,2,0.5,0,0,,0.75,0,0,,0,4,4,0,0,0,0,1,3
106,Sam Dekker,SF,21,HOU,3,0,6,0,0,,0,0,,0,0,,,0,0,,0,1,1,0,1,0,0,0,0
107,Matthew Dellavedova,SG,25,CLE,42,11,1136,130,302,0.43,59,136,0.434,71,166,0.428,0.528,35,39,0.897,23,79,102,204,31,5,63,95,354
108,Luol Deng,SF,30,MIA,39,38,1218,141,337,0.418,47,134,0.351,94,203,0.463,0.488,58,73,0.795,35,145,180,61,35,14,36,59,387
109,DeMar DeRozan,SG,26,TOR,45,45,1642,351,794,0.442,27,84,0.321,324,710,0.456,0.459,308,365,0.844,35,169,204,185,45,14,103,90,1037
110,Boris Diaw,PF,33,SAS,45,0,858,131,245,0.535,18,46,0.391,113,199,0.568,0.571,40,53,0.755,38,108,146,112,18,12,60,62,320
111,Gorgui Dieng,C,26,MIN,46,3,1094,139,275,0.505,1,2,0.5,138,273,0.505,0.507,92,106,0.868,75,221,296,60,53,47,89,119,371
112,Spencer Dinwiddie,PG,22,DET,9,0,111,14,35,0.4,1,7,0.143,13,28,0.464,0.414,11,19,0.579,0,9,9,13,2,0,5,16,40
113,Toney Douglas,PG,29,NOP,23,0,346,54,117,0.462,23,52,0.442,31,65,0.477,0.56,23,26,0.885,8,20,28,48,24,1,18,43,154
114,Goran Dragic,SG,29,MIA,37,37,1202,184,395,0.466,34,104,0.327,150,291,0.515,0.509,52,72,0.722,25,97,122,186,37,9,92,90,454
115,Andre Drummond,C,22,DET,45,45,1515,324,627,0.517,1,3,0.333,323,624,0.518,0.518,121,349,0.347,237,445,682,38,78,65,96,140,770
116,Jared Dudley,PF,30,WAS,42,26,1206,131,272,0.482,62,133,0.466,69,139,0.496,0.596,39,52,0.75,31,126,157,77,40,5,41,96,363
117,Tim Duncan,C,39,SAS,37,37,960,135,267,0.506,0,2,0,135,265,0.509,0.506,58,78,0.744,64,215,279,110,33,49,63,88,328
118,Kevin Durant,SF,27,OKC,40,40,1435,370,732,0.505,93,240,0.388,277,492,0.563,0.569,249,281,0.886,18,297,315,182,40,47,121,66,1082
119,Cleanthony Early,SF,24,NYK,10,0,34,3,6,0.5,1,4,0.25,2,2,1,0.583,0,0,,0,2,2,1,1,1,1,3,7
120,Jarell Eddie,SF,24,WAS,11,0,76,13,36,0.361,12,30,0.4,1,6,0.167,0.528,4,4,1,1,12,13,2,2,1,0,3,42
121,Wayne Ellington,SG,28,BRK,45,11,854,110,293,0.375,41,131,0.313,69,162,0.426,0.445,26,32,0.813,9,84,93,40,30,3,27,42,287
122,Monta Ellis,SG,30,IND,45,45,1501,249,572,0.435,38,136,0.279,211,436,0.484,0.469,81,109,0.743,19,106,125,223,77,24,122,95,617
123,James Ennis,SF,25,MEM,7,0,28,3,8,0.375,2,5,0.4,1,3,0.333,0.5,5,8,0.625,2,3,5,2,3,2,2,1,13
124,Tyler Ennis,PG,21,MIL,20,5,186,23,57,0.404,4,13,0.308,19,44,0.432,0.439,7,10,0.7,3,15,18,20,4,1,12,20,57
125,Jeremy Evans,SF,28,DAL,26,2,232,21,41,0.512,3,14,0.214,18,27,0.667,0.549,13,18,0.722,10,41,51,2,6,9,7,18,58
126,Tyreke Evans,PG,26,NOP,25,25,765,136,314,0.433,33,85,0.388,103,229,0.45,0.486,74,93,0.796,20,109,129,164,32,8,73,66,379
127,Festus Ezeli,C,26,GSW,40,11,710,117,210,0.557,0,0,,117,210,0.557,0.557,66,124,0.532,83,151,234,31,17,49,36,92,300
128,Kenneth Faried,PF,26,DEN,38,36,995,194,363,0.534,0,1,0,194,362,0.536,0.534,77,136,0.566,138,198,336,42,17,40,53,99,465
129,Derrick Favors,PF,24,UTA,27,26,868,184,350,0.526,0,1,0,184,349,0.527,0.526,84,119,0.706,85,144,229,41,38,30,40,66,452
130,Cristiano Felicio,C,23,CHI,3,0,6,1,2,0.5,0,1,0,1,1,1,0.5,0,0,,0,1,1,1,0,0,0,0,2
131,Raymond Felton,PG,31,DAL,46,20,1228,155,378,0.41,41,125,0.328,114,253,0.451,0.464,76,89,0.854,16,132,148,155,37,7,72,75,427
132,Evan Fournier,SF,23,ORL,44,41,1402,216,498,0.434,87,227,0.383,129,271,0.476,0.521,86,102,0.843,19,107,126,117,58,2,65,111,605
133,Randy Foye,SG,32,DEN,45,7,891,97,287,0.338,40,143,0.28,57,144,0.396,0.408,37,45,0.822,16,69,85,95,21,12,50,67,271
134,Tim Frazier,PG,25,POR,31,1,252,19,57,0.333,3,16,0.188,16,41,0.39,0.36,8,13,0.615,10,27,37,41,10,1,26,30,49
135,Jimmer Fredette,SG,26,NOP,4,0,13,1,4,0.25,0,1,0,1,3,0.333,0.25,0,0,,0,0,0,1,1,0,1,1,2
136,Channing Frye,C,32,ORL,39,29,690,74,168,0.44,46,111,0.414,28,57,0.491,0.577,19,21,0.905,20,104,124,43,20,18,27,64,213
137,Danilo Gallinari,SF,27,DEN,39,39,1344,207,512,0.404,64,179,0.358,143,333,0.429,0.467,269,307,0.876,42,179,221,98,26,16,53,67,747
138,Langston Galloway,PG,24,NYK,47,1,1137,133,315,0.422,47,122,0.385,86,193,0.446,0.497,55,69,0.797,25,138,163,104,38,10,33,94,368
139,Kevin Garnett,PF,39,MIN,38,38,556,54,115,0.47,0,1,0,54,114,0.474,0.47,14,21,0.667,15,135,150,62,28,10,16,70,122
140,Marc Gasol,C,31,MEM,46,46,1618,289,638,0.453,2,3,0.667,287,635,0.452,0.455,187,224,0.835,57,272,329,175,43,61,107,128,767
141,Pau Gasol,C,35,CHI,42,42,1330,277,592,0.468,9,26,0.346,268,566,0.473,0.476,133,168,0.792,99,359,458,131,23,90,83,83,696
142,Rudy Gay,SF,29,SAC,40,40,1366,284,606,0.469,41,125,0.328,243,481,0.505,0.502,110,141,0.78,64,212,276,68,49,29,72,103,719
143,Alonzo Gee,SF,28,NOP,44,29,932,72,147,0.49,12,40,0.3,60,107,0.561,0.531,21,27,0.778,36,117,153,44,35,8,29,102,177
144,Paul George,PF,25,IND,45,45,1597,341,821,0.415,128,336,0.381,213,485,0.439,0.493,264,311,0.849,42,287,329,171,88,14,167,129,1074
145,Taj Gibson,PF,30,CHI,44,26,1120,144,280,0.514,0,2,0,144,278,0.518,0.514,52,77,0.675,126,184,310,56,22,43,47,103,340
146,Manu Ginobili,SG,38,SAS,39,0,769,143,309,0.463,46,123,0.374,97,186,0.522,0.537,67,86,0.779,21,95,116,132,43,8,65,60,399
147,Rudy Gobert,C,23,UTA,24,23,788,85,145,0.586,0,0,,85,145,0.586,0.586,59,96,0.615,78,171,249,40,19,62,44,75,229
148,Drew Gooden,PF,34,WAS,14,0,193,19,60,0.317,4,23,0.174,15,37,0.405,0.35,6,8,0.75,22,33,55,9,4,7,8,23,48
149,Archie Goodwin,SG,21,PHO,26,4,401,65,143,0.455,8,27,0.296,57,116,0.491,0.483,59,92,0.641,7,50,57,38,13,7,30,27,197
150,Aaron Gordon,PF,20,ORL,43,3,867,118,243,0.486,20,61,0.328,98,182,0.538,0.527,61,88,0.693,73,152,225,54,24,28,36,78,317
151,Eric Gordon,SG,27,NOP,41,40,1371,205,500,0.41,101,268,0.377,104,232,0.448,0.511,100,113,0.885,10,78,88,110,39,12,65,89,611
152,Marcin Gortat,C,31,WAS,37,37,1174,209,396,0.528,0,0,,209,396,0.528,0.528,78,103,0.757,105,261,366,59,27,49,71,94,496
153,Jerami Grant,SF,21,PHI,44,29,1125,134,317,0.423,18,82,0.22,116,235,0.494,0.451,108,161,0.671,54,141,195,61,32,69,56,127,394
154,Jerian Grant,PG,23,NYK,44,0,703,74,213,0.347,7,49,0.143,67,164,0.409,0.364,57,69,0.826,12,65,77,107,23,5,49,60,212
155,Danny Green,SG,28,SAS,45,45,1126,112,310,0.361,63,188,0.335,49,122,0.402,0.463,20,25,0.8,25,139,164,82,34,33,49,64,307
156,Draymond Green,PF,25,GSW,44,44,1514,227,482,0.471,63,155,0.406,164,327,0.502,0.536,127,186,0.683,79,340,419,320,62,57,123,125,644
157,Erick Green,PG,24,DEN,3,0,7,0,1,0,0,1,0,0,0,,0,0,0,,0,1,1,1,0,0,0,0,0
158,Gerald Green,SG,30,MIA,40,9,1043,157,394,0.398,60,182,0.33,97,212,0.458,0.475,48,61,0.787,16,84,100,39,21,14,35,85,422
159,JaMychal Green,PF,25,MEM,45,2,667,96,195,0.492,9,17,0.529,87,178,0.489,0.515,52,68,0.765,56,126,182,16,14,14,44,99,253
160,Jeff Green,SF,29,MEM,46,31,1320,191,460,0.415,29,105,0.276,162,355,0.456,0.447,106,135,0.785,48,159,207,87,33,16,64,90,517
161,Blake Griffin,PF,26,LAC,30,30,1048,281,553,0.508,6,17,0.353,275,536,0.513,0.514,129,178,0.725,49,211,260,149,21,17,71,85,697
162,P.J. Hairston,SF,23,CHO,42,42,849,94,257,0.366,50,159,0.314,44,98,0.449,0.463,32,40,0.8,17,101,118,27,22,6,19,99,270
163,Tyler Hansbrough,PF,30,CHO,25,0,205,20,47,0.426,2,3,0.667,18,44,0.409,0.447,16,32,0.5,27,27,54,6,5,5,11,36,58
164,Tim Hardaway,SG,23,ATL,15,0,213,21,59,0.356,8,31,0.258,13,28,0.464,0.424,8,9,0.889,3,16,19,15,6,2,5,13,58
165,James Harden,SG,26,HOU,47,47,1761,383,902,0.425,128,374,0.342,255,528,0.483,0.496,408,471,0.866,38,259,297,328,69,31,211,129,1302
166,Maurice Harkless,SF,22,POR,47,0,795,90,198,0.455,19,72,0.264,71,126,0.563,0.503,31,54,0.574,46,96,142,39,24,16,41,55,230
167,Montrezl Harrell,PF,22,HOU,25,1,257,34,52,0.654,0,0,,34,52,0.654,0.654,19,35,0.543,15,27,42,9,6,6,11,38,87
168,Devin Harris,PG,32,DAL,40,0,784,104,226,0.46,28,83,0.337,76,143,0.531,0.522,60,88,0.682,13,71,84,83,38,8,38,80,296
169,Gary Harris,SG,21,DEN,39,39,1185,168,366,0.459,53,141,0.376,115,225,0.511,0.531,46,58,0.793,26,79,105,71,45,10,56,76,435
170,Joe Harris,SG,24,CLE,5,0,15,1,4,0.25,1,4,0.25,0,0,,0.375,0,0,,0,3,3,2,0,0,1,1,3
171,Tobias Harris,PF,23,ORL,44,44,1455,226,488,0.463,42,135,0.311,184,353,0.521,0.506,110,141,0.78,63,248,311,96,44,28,70,84,604
172,Aaron Harrison,SG,21,CHO,11,0,47,2,7,0.286,1,3,0.333,1,4,0.25,0.357,2,6,0.333,3,5,8,0,2,0,1,1,7
173,Udonis Haslem,PF,35,MIA,23,0,196,15,42,0.357,1,6,0.167,14,36,0.389,0.369,8,9,0.889,8,45,53,13,4,2,5,15,39
174,Spencer Hawes,PF,27,CHO,39,3,707,85,210,0.405,26,72,0.361,59,138,0.428,0.467,36,42,0.857,32,135,167,75,16,11,39,77,232
175,Chuck Hayes,C,32,HOU,2,0,24,1,2,0.5,0,0,,1,2,0.5,0.5,2,2,1,0,8,8,2,0,0,3,6,4
176,Gordon Hayward,SF,25,UTA,44,44,1566,286,663,0.431,83,224,0.371,203,439,0.462,0.494,220,268,0.821,35,184,219,159,52,14,115,96,875
177,Gerald Henderson,SG,28,POR,38,0,622,97,239,0.406,25,68,0.368,72,171,0.421,0.458,44,61,0.721,14,81,95,36,9,8,33,30,263
178,John Henson,C,25,MIL,42,1,700,120,203,0.591,0,0,,120,203,0.591,0.591,44,82,0.537,61,103,164,41,11,83,48,100,284
179,Mario Hezonja,SF,20,ORL,41,0,560,67,159,0.421,25,68,0.368,42,91,0.462,0.5,30,32,0.938,17,51,68,39,8,5,41,50,189
180,Roy Hibbert,C,29,LAL,47,47,1182,117,263,0.445,0,2,0,117,261,0.448,0.445,87,103,0.845,81,180,261,69,17,77,55,150,321
181,J.J. Hickson,C,27,DEN,18,9,303,55,109,0.505,0,0,,55,109,0.505,0.505,27,59,0.458,22,65,87,16,10,12,16,35,137
182,Nene Hilario,PF,33,WAS,22,6,404,77,142,0.542,0,1,0,77,141,0.546,0.542,31,59,0.525,17,79,96,36,25,9,29,65,185
183,George Hill,PG,29,IND,38,37,1336,176,399,0.441,72,167,0.431,104,232,0.448,0.531,60,81,0.741,29,119,148,119,52,9,58,79,484
184,Jordan Hill,PF,28,IND,41,6,881,159,317,0.502,0,1,0,159,316,0.503,0.502,59,86,0.686,103,185,288,47,24,14,53,98,377
185,Solomon Hill,SF,24,IND,23,1,245,27,67,0.403,3,20,0.15,24,47,0.511,0.425,10,10,1,11,34,45,17,10,8,7,21,67
186,Darrun Hilliard,SF,22,DET,14,0,89,12,38,0.316,4,12,0.333,8,26,0.308,0.368,9,11,0.818,3,8,11,4,1,0,5,5,37
187,Kirk Hinrich,SG,35,CHI,28,6,441,40,93,0.43,19,45,0.422,21,48,0.438,0.532,15,16,0.938,4,37,41,44,12,1,21,49,114
188,Jrue Holiday,PG,25,NOP,38,14,961,198,442,0.448,46,121,0.38,152,321,0.474,0.5,88,112,0.786,12,92,104,198,43,13,82,86,530
189,Justin Holiday,SG,26,ATL,25,1,260,23,71,0.324,10,44,0.227,13,27,0.481,0.394,5,10,0.5,3,23,26,11,13,4,13,21,61
190,Ryan Hollins,C,31,MEM,7,0,67,9,15,0.6,0,0,,9,15,0.6,0.6,2,3,0.667,8,8,16,3,2,5,3,11,20
191,Rondae Hollis-Jefferson,SF,21,BRK,19,14,419,39,81,0.481,1,5,0.2,38,76,0.5,0.488,20,30,0.667,32,84,116,27,27,8,21,42,99
192,Richaun Holmes,PF,22,PHI,34,1,485,83,148,0.561,6,31,0.194,77,117,0.658,0.581,36,52,0.692,41,47,88,22,11,25,19,60,208
193,Rodney Hood,SG,23,UTA,42,42,1283,200,482,0.415,80,221,0.362,120,261,0.46,0.498,100,114,0.877,18,117,135,109,37,10,68,124,580
194,Al Horford,C,29,ATL,46,46,1444,300,598,0.502,44,135,0.326,256,463,0.553,0.538,57,73,0.781,99,229,328,135,39,67,60,87,701
195,Dwight Howard,C,30,HOU,37,37,1204,197,322,0.612,0,2,0,197,320,0.616,0.612,140,254,0.551,134,313,447,56,37,59,90,118,534
196,Marcelo Huertas,PG,32,LAL,27,0,319,31,77,0.403,7,24,0.292,24,53,0.453,0.448,6,6,1,9,25,34,67,13,2,32,33,75
197,Kris Humphries,PF,30,WAS,27,14,462,64,157,0.408,23,66,0.348,41,91,0.451,0.481,29,31,0.935,26,87,113,16,3,14,20,42,180
198,R.J. Hunter,SG,22,BOS,23,0,244,25,73,0.342,12,48,0.25,13,25,0.52,0.425,5,6,0.833,2,27,29,9,12,4,7,29,67
199,Serge Ibaka,PF,26,OKC,47,47,1543,263,533,0.493,37,96,0.385,226,437,0.517,0.528,55,72,0.764,90,235,325,40,19,103,74,122,618
200,Andre Iguodala,SG,32,GSW,45,1,1236,130,262,0.496,43,112,0.384,87,150,0.58,0.578,36,53,0.679,42,152,194,155,57,16,56,73,339
201,Ersan Ilyasova,PF,28,DET,45,45,1253,188,440,0.427,69,186,0.371,119,254,0.469,0.506,65,90,0.722,90,161,251,54,33,26,49,107,510
202,Joe Ingles,SF,28,UTA,43,0,610,67,161,0.416,41,110,0.373,26,51,0.51,0.543,5,6,0.833,8,63,71,45,23,3,31,56,180
203,Damien Inglis,SF,20,MIL,8,0,42,2,8,0.25,1,5,0.2,1,3,0.333,0.313,3,4,0.75,1,8,9,2,2,0,4,5,8
204,Kyrie Irving,PG,23,CLE,17,17,461,103,251,0.41,20,71,0.282,83,180,0.461,0.45,44,50,0.88,19,35,54,65,13,4,34,22,270
205,Jarrett Jack,PG,32,BRK,32,32,1027,140,358,0.391,31,102,0.304,109,256,0.426,0.434,100,112,0.893,9,127,136,236,34,7,94,77,411
206,Reggie Jackson,PG,25,DET,45,45,1393,321,732,0.439,64,183,0.35,257,549,0.468,0.482,156,186,0.839,37,129,166,295,38,3,125,95,862
207,LeBron James,SF,31,CLE,42,42,1504,401,796,0.504,48,164,0.293,353,632,0.559,0.534,201,283,0.71,51,251,302,264,58,29,137,81,1051
208,Al Jefferson,C,31,CHO,19,17,478,107,222,0.482,0,0,,107,222,0.482,0.482,24,42,0.571,23,93,116,30,14,20,14,46,238
209,Cory Jefferson,PF,25,PHO,7,0,45,7,20,0.35,0,1,0,7,19,0.368,0.35,2,4,0.5,5,10,15,0,0,1,0,8,16
210,Richard Jefferson,SF,35,CLE,39,3,760,79,181,0.436,36,96,0.375,43,85,0.506,0.536,29,50,0.58,7,49,56,33,19,12,26,74,223
211,John Jenkins,SG,24,DAL,19,1,178,26,61,0.426,3,18,0.167,23,43,0.535,0.451,7,8,0.875,4,17,21,8,3,0,11,9,62
212,Brandon Jennings,PG,26,DET,14,0,245,31,85,0.365,13,42,0.31,18,43,0.419,0.441,20,27,0.741,4,25,29,50,6,0,14,13,95
213,Jonas Jerebko,PF,28,BOS,45,0,611,56,148,0.378,20,49,0.408,36,99,0.364,0.446,27,35,0.771,40,100,140,38,12,7,27,75,159
214,Amir Johnson,PF,28,BOS,43,40,1023,147,253,0.581,9,34,0.265,138,219,0.63,0.599,38,68,0.559,92,178,270,74,29,50,51,120,341
215,Chris Johnson,SF,25,UTA,35,1,386,36,95,0.379,13,46,0.283,23,49,0.469,0.447,15,20,0.75,10,48,58,26,19,7,19,46,100
216,James Johnson,PF,28,TOR,37,16,566,74,144,0.514,11,33,0.333,63,111,0.568,0.552,25,40,0.625,19,60,79,38,19,19,35,48,184
217,Joe Johnson,SF,34,BRK,46,46,1578,199,505,0.394,68,185,0.368,131,320,0.409,0.461,63,76,0.829,32,147,179,173,32,1,87,85,529
218,Stanley Johnson,SF,19,DET,45,1,1002,141,369,0.382,41,126,0.325,100,243,0.412,0.438,46,60,0.767,36,141,177,61,32,7,64,104,369
219,Tyler Johnson,SG,23,MIA,36,5,863,118,242,0.488,27,70,0.386,91,172,0.529,0.543,51,64,0.797,28,81,109,79,24,14,47,66,314
220,Wesley Johnson,SF,28,LAC,45,4,819,109,251,0.434,58,163,0.356,51,88,0.58,0.55,17,28,0.607,20,91,111,25,39,24,26,85,293
221,Nikola Jokic,C,20,DEN,43,18,817,149,270,0.552,10,28,0.357,139,242,0.574,0.57,80,99,0.808,89,144,233,75,39,23,52,95,388
222,James Jones,SF,35,CLE,34,0,336,37,100,0.37,27,76,0.355,10,24,0.417,0.505,16,21,0.762,6,31,37,13,8,6,10,44,117
223,Terrence Jones,PF,24,HOU,41,11,938,151,329,0.459,25,72,0.347,126,257,0.49,0.497,65,100,0.65,58,134,192,40,20,37,46,77,392
224,Tyus Jones,PG,19,MIN,9,0,98,11,31,0.355,2,4,0.5,9,27,0.333,0.387,3,5,0.6,3,12,15,14,4,1,8,6,27
225,DeAndre Jordan,C,27,LAC,43,43,1436,187,262,0.714,0,0,,187,262,0.714,0.714,137,331,0.414,156,423,579,43,20,96,48,121,511
226,Cory Joseph,PG,24,TOR,45,0,1156,138,303,0.455,14,52,0.269,124,251,0.494,0.479,86,114,0.754,20,92,112,136,38,13,60,75,376
227,Chris Kaman,C,33,POR,7,2,62,10,27,0.37,0,1,0,10,26,0.385,0.37,0,0,,3,6,9,5,0,0,5,6,20
228,Frank Kaminsky,C,22,CHO,44,0,946,119,301,0.395,38,109,0.349,81,192,0.422,0.458,65,89,0.73,37,143,180,60,21,25,35,69,341
229,Enes Kanter,C,23,OKC,47,0,968,212,385,0.551,2,5,0.4,210,380,0.553,0.553,109,140,0.779,133,220,353,25,9,20,58,89,535
230,Sergey Karasev,SF,22,BRK,21,0,127,9,22,0.409,2,10,0.2,7,12,0.583,0.455,6,6,1,2,15,17,7,1,0,7,6,26
231,Sasha Kaun,C,30,CLE,9,0,39,3,5,0.6,0,0,,3,5,0.6,0.6,2,4,0.5,8,2,10,2,2,2,6,6,8
232,Ryan Kelly,PF,24,LAL,17,0,229,30,79,0.38,5,26,0.192,25,53,0.472,0.411,24,33,0.727,10,55,65,14,5,7,10,15,89
233,Sean Kilpatrick,SG,26,DEN,6,0,50,6,16,0.375,4,14,0.286,2,2,1,0.5,7,8,0.875,2,3,5,1,2,0,1,5,23
234,Brandon Knight,SG,24,PHO,42,41,1523,309,728,0.424,87,261,0.333,222,467,0.475,0.484,122,144,0.847,27,130,157,215,54,13,145,99,827
235,Kyle Korver,SG,34,ATL,44,44,1338,149,351,0.425,83,225,0.369,66,126,0.524,0.543,31,36,0.861,7,149,156,95,36,20,62,88,412
236,Kosta Koufos,PF,26,SAC,44,8,891,136,255,0.533,0,0,,136,255,0.533,0.533,40,69,0.58,102,155,257,12,24,40,33,114,312
237,Jeremy Lamb,SG,23,CHO,38,0,823,165,352,0.469,38,122,0.311,127,230,0.552,0.523,47,61,0.77,32,140,172,50,24,17,34,62,415
238,Carl Landry,PF,32,PHI,11,2,141,35,61,0.574,1,2,0.5,34,59,0.576,0.582,15,23,0.652,10,22,32,4,5,3,9,19,86
239,Shane Larkin,PG,23,BRK,42,5,859,114,257,0.444,23,61,0.377,91,196,0.464,0.488,36,45,0.8,8,81,89,157,55,9,68,66,287
240,Joffrey Lauvergne,C,24,DEN,26,15,472,88,175,0.503,12,29,0.414,76,146,0.521,0.537,25,28,0.893,41,101,142,30,7,7,24,54,213
241,Zach LaVine,PG,20,MIN,46,6,1066,206,493,0.418,44,134,0.328,162,359,0.451,0.462,98,117,0.838,20,122,142,147,30,5,89,104,554
242,Ty Lawson,PG,28,HOU,40,12,976,96,244,0.393,25,77,0.325,71,167,0.425,0.445,50,70,0.714,18,57,75,158,36,5,70,59,267
243,Courtney Lee,SG,30,MEM,44,30,1299,168,372,0.452,41,117,0.35,127,255,0.498,0.507,70,82,0.854,18,95,113,63,47,12,41,67,447
244,David Lee,PF,32,BOS,30,4,470,87,192,0.453,0,1,0,87,191,0.455,0.453,40,51,0.784,41,89,130,54,12,13,38,51,214
245,Alex Len,C,22,PHO,43,18,839,113,245,0.461,1,4,0.25,112,241,0.465,0.463,72,99,0.727,77,181,258,37,22,39,59,110,299
246,Kawhi Leonard,SF,24,SAS,43,43,1402,310,615,0.504,77,160,0.481,233,455,0.512,0.567,161,182,0.885,54,239,293,110,82,39,59,78,858
247,Meyers Leonard,PF,23,POR,40,9,934,137,309,0.443,56,161,0.348,81,148,0.547,0.534,25,33,0.758,36,167,203,62,6,12,49,122,355
248,Jon Leuer,PF,26,PHO,41,22,853,149,303,0.492,33,81,0.407,116,222,0.523,0.546,39,53,0.736,42,191,233,54,24,18,51,85,370
249,Damian Lillard,PG,25,POR,40,40,1443,334,794,0.421,121,322,0.376,213,472,0.451,0.497,184,211,0.872,27,148,175,283,36,13,134,95,973
250,Jeremy Lin,PG,27,CHO,43,9,1188,182,425,0.428,43,134,0.321,139,291,0.478,0.479,137,171,0.801,26,115,141,140,29,27,82,103,544
251,Shaun Livingston,PG,30,GSW,42,2,834,113,217,0.521,1,11,0.091,112,206,0.544,0.523,37,40,0.925,26,54,80,120,24,11,37,73,264
252,Brook Lopez,C,27,BRK,46,46,1533,358,724,0.494,0,5,0,358,719,0.498,0.494,186,236,0.788,134,251,385,73,32,86,105,139,902
253,Robin Lopez,C,27,NYK,47,47,1177,178,344,0.517,0,0,,178,344,0.517,0.517,60,74,0.811,121,162,283,70,9,64,75,119,416
254,Kevin Love,PF,27,CLE,43,43,1395,226,543,0.416,85,238,0.357,141,305,0.462,0.494,131,167,0.784,100,362,462,101,40,22,87,89,668
255,Kyle Lowry,PG,29,TOR,45,45,1642,298,703,0.424,125,322,0.388,173,381,0.454,0.513,220,249,0.884,30,193,223,287,100,24,135,123,941
256,Trey Lyles,PF,20,UTA,42,28,778,82,192,0.427,19,42,0.452,63,150,0.42,0.477,25,41,0.61,42,134,176,31,12,11,35,62,208
257,Shelvin Mack,PG,25,ATL,19,0,160,34,80,0.425,4,23,0.174,30,57,0.526,0.45,8,11,0.727,2,16,18,35,7,0,12,6,80
258,Ian Mahinmi,C,29,IND,40,40,960,136,225,0.604,0,0,,136,225,0.604,0.604,67,121,0.554,86,201,287,53,38,40,46,128,339
259,Devyn Marble,SG,23,ORL,8,0,20,1,6,0.167,0,2,0,1,4,0.25,0.167,0,1,0,1,2,3,0,1,0,1,2,2
260,Boban Marjanovic,C,27,SAS,27,1,224,56,91,0.615,0,0,,56,91,0.615,0.615,43,59,0.729,36,56,92,9,8,13,17,29,155
261,Kendall Marshall,PG,24,PHI,12,5,172,18,53,0.34,6,21,0.286,12,32,0.375,0.396,4,6,0.667,1,12,13,39,6,0,25,8,46
262,Jarell Martin,PF,21,MEM,2,0,9,1,5,0.2,0,0,,1,5,0.2,0.2,0,0,,0,0,0,0,0,0,0,2,2
263,Kevin Martin,SG,32,MIN,35,12,791,121,323,0.375,36,99,0.364,85,224,0.379,0.43,117,132,0.886,9,62,71,44,16,1,34,60,395
264,Wesley Matthews,SG,29,DAL,43,43,1419,188,481,0.391,106,296,0.358,82,185,0.443,0.501,70,82,0.854,18,115,133,77,45,12,46,93,552
265,O.J. Mayo,SG,28,MIL,29,12,786,99,265,0.374,35,119,0.294,64,146,0.438,0.44,30,38,0.789,10,66,76,90,34,4,46,80,263
266,Luc Mbah a Moute,PF,29,LAC,43,29,672,47,110,0.427,9,26,0.346,38,84,0.452,0.468,22,36,0.611,39,64,103,14,16,14,18,55,125
267,James Michael McAdoo,PF,23,GSW,25,0,147,22,40,0.55,0,0,,22,40,0.55,0.55,13,27,0.481,14,18,32,9,7,5,9,18,57
268,Ray McCallum,PG,24,SAS,19,2,188,20,47,0.426,2,9,0.222,18,38,0.474,0.447,6,6,1,4,17,21,24,4,3,10,12,48
269,C.J. McCollum,SG,24,POR,45,45,1581,364,826,0.441,112,285,0.393,252,541,0.466,0.508,95,119,0.798,26,134,160,196,51,9,100,104,935
270,T.J. McConnell,PG,23,PHI,46,16,972,122,262,0.466,20,60,0.333,102,202,0.505,0.504,16,26,0.615,26,148,174,222,61,8,95,66,280
271,K.J. McDaniels,SG,22,HOU,15,0,59,8,25,0.32,2,7,0.286,6,18,0.333,0.36,3,5,0.6,4,9,13,1,3,4,4,12,21
272,Doug McDermott,SF,24,CHI,43,4,932,128,297,0.431,56,131,0.427,72,166,0.434,0.525,16,19,0.842,21,80,101,30,7,4,32,62,328
273,Mitch McGary,PF,23,OKC,13,0,55,6,14,0.429,0,3,0,6,11,0.545,0.429,4,8,0.5,4,9,13,2,0,2,6,8,16
274,JaVale McGee,C,28,DAL,26,2,310,65,113,0.575,0,0,,65,113,0.575,0.575,16,32,0.5,43,72,115,2,4,24,17,41,146
275,Ben McLemore,SG,22,SAC,45,39,944,123,270,0.456,37,103,0.359,86,167,0.515,0.524,49,69,0.71,22,71,93,52,37,7,67,90,332
276,Josh McRoberts,PF,28,MIA,20,0,311,24,60,0.4,3,22,0.136,21,38,0.553,0.425,15,22,0.682,15,44,59,36,10,3,17,33,66
277,Jodie Meeks,SG,28,DET,2,0,17,1,5,0.2,0,0,,1,5,0.2,0.2,0,0,,1,1,2,0,0,0,1,2,2
278,Salah Mejri,C,29,DAL,9,2,105,16,21,0.762,0,0,,16,21,0.762,0.762,9,13,0.692,10,20,30,2,1,8,7,13,41
279,Jordan Mickey,PF,21,BOS,3,0,6,2,3,0.667,0,0,,2,3,0.667,0.667,3,3,1,2,1,3,1,0,1,0,1,7
280,Khris Middleton,SG,24,MIL,47,47,1691,292,658,0.444,95,224,0.424,197,434,0.454,0.516,162,183,0.885,18,150,168,190,52,9,88,124,841
281,C.J. Miles,SF,28,IND,40,24,1053,166,424,0.392,93,264,0.352,73,160,0.456,0.501,73,98,0.745,20,110,130,44,43,20,47,96,498
282,Andre Miller,PG,39,MIN,20,0,216,28,46,0.609,1,2,0.5,27,44,0.614,0.62,14,18,0.778,5,12,17,47,9,0,17,27,71
283,Mike Miller,SF,35,DEN,33,1,281,16,44,0.364,14,39,0.359,2,5,0.4,0.523,0,0,,6,37,43,32,10,3,12,36,46
284,Patrick Mills,PG,27,SAS,45,2,908,135,314,0.43,61,161,0.379,74,153,0.484,0.527,16,20,0.8,11,68,79,109,39,3,40,50,347
285,Elijah Millsap,SG,28,UTA,20,0,173,11,39,0.282,1,12,0.083,10,27,0.37,0.295,13,18,0.722,6,29,35,19,7,3,9,33,36
286,Paul Millsap,PF,30,ATL,45,45,1470,294,594,0.495,36,119,0.303,258,475,0.543,0.525,206,263,0.783,115,281,396,156,85,61,104,134,830
287,Nikola Mirotic,PF,24,CHI,44,31,1056,150,389,0.386,74,209,0.354,76,180,0.422,0.481,92,118,0.78,43,215,258,61,38,29,67,90,466
288,Greg Monroe,C,25,MIL,45,45,1365,296,574,0.516,0,0,,296,574,0.516,0.516,135,179,0.754,137,304,441,105,44,40,77,99,727
289,Luis Montero,SG,22,POR,7,0,23,5,13,0.385,1,5,0.2,4,8,0.5,0.423,2,2,1,0,2,2,1,0,0,2,1,13
290,E'Twaun Moore,SG,26,CHI,32,0,485,65,133,0.489,13,32,0.406,52,101,0.515,0.538,11,19,0.579,6,46,52,26,16,4,19,37,154
291,Eric Moreland,PF,24,SAC,5,0,24,2,3,0.667,0,0,,2,3,0.667,0.667,0,2,0,1,5,6,0,0,4,0,2,4
292,Marcus Morris,SF,26,DET,44,44,1602,219,521,0.42,46,147,0.313,173,374,0.463,0.464,122,158,0.772,57,174,231,94,39,13,78,94,606
293,Markieff Morris,PF,26,PHO,29,19,662,119,311,0.383,17,57,0.298,102,254,0.402,0.41,40,57,0.702,31,111,142,55,21,8,63,80,295
294,Anthony Morrow,SG,30,OKC,41,5,617,83,199,0.417,50,122,0.41,33,77,0.429,0.543,17,21,0.81,7,38,45,14,18,3,9,43,233
295,Donatas Motiejunas,PF,25,HOU,14,1,188,31,62,0.5,7,17,0.412,24,45,0.533,0.556,9,14,0.643,7,23,30,14,6,2,25,25,78
296,Timofey Mozgov,C,29,CLE,40,30,715,103,200,0.515,1,7,0.143,102,193,0.528,0.518,42,55,0.764,58,113,171,17,14,31,41,84,249
297,Emmanuel Mudiay,PG,19,DEN,31,29,918,127,392,0.324,25,95,0.263,102,297,0.343,0.356,62,97,0.639,18,85,103,177,31,19,116,65,341
298,Shabazz Muhammad,SG,23,MIN,46,0,937,169,354,0.477,26,83,0.313,143,271,0.528,0.514,94,122,0.77,46,95,141,22,10,4,42,55,458
299,Mike Muscala,PF,24,ATL,32,0,349,43,93,0.462,9,29,0.31,34,64,0.531,0.511,15,18,0.833,16,52,68,17,8,15,19,40,110
300,Larry Nance Jr.,PF,23,LAL,38,22,780,100,186,0.538,1,3,0.333,99,183,0.541,0.54,20,28,0.714,57,135,192,25,33,10,25,74,221
301,Shabazz Napier,PG,24,ORL,38,0,473,52,153,0.34,24,72,0.333,28,81,0.346,0.418,29,36,0.806,8,32,40,76,20,1,38,33,157
302,Gary Neal,SG,31,WAS,35,2,737,137,296,0.463,38,91,0.418,99,205,0.483,0.527,46,53,0.868,11,63,74,44,18,1,28,51,358
303,Jameer Nelson,PG,33,DEN,36,15,995,111,299,0.371,41,139,0.295,70,160,0.438,0.44,30,35,0.857,19,91,110,183,25,5,64,95,293
304,Raul Neto,PG,23,UTA,43,42,817,95,229,0.415,35,91,0.385,60,138,0.435,0.491,20,27,0.741,12,50,62,99,38,2,59,67,245
305,Andrew Nicholson,PF,26,ORL,32,0,521,84,186,0.452,24,68,0.353,60,118,0.508,0.516,23,30,0.767,23,101,124,11,6,10,27,44,215
306,Joakim Noah,C,30,CHI,29,2,635,51,133,0.383,0,1,0,51,132,0.386,0.383,22,45,0.489,87,168,255,110,18,29,52,77,124
307,Nerlens Noel,PF,21,PHI,40,36,1171,174,336,0.518,0,0,,174,336,0.518,0.518,73,127,0.575,89,243,332,53,63,63,97,99,421
308,Lucas Nogueira,C,23,TOR,15,0,115,18,24,0.75,1,2,0.5,17,22,0.773,0.771,4,7,0.571,7,15,22,3,7,4,4,15,41
309,Steve Novak,PF,32,OKC,5,0,21,4,9,0.444,3,6,0.5,1,3,0.333,0.611,0,0,,0,3,3,0,0,0,0,1,11
310,Dirk Nowitzki,PF,37,DAL,43,43,1322,274,612,0.448,76,191,0.398,198,421,0.47,0.51,133,147,0.905,31,255,286,77,26,26,46,79,757
311,Jusuf Nurkic,C,21,DEN,8,0,99,19,55,0.345,0,0,,19,55,0.345,0.345,17,28,0.607,15,23,38,3,1,9,6,22,55
312,J.J. O'Brien,SF,23,UTA,2,0,6,0,1,0,0,0,,0,1,0,0,0,0,,0,1,1,0,1,0,0,1,0
313,Johnny O'Bryant,PF,22,MIL,43,3,629,64,148,0.432,1,1,1,63,147,0.429,0.436,22,33,0.667,50,80,130,27,15,7,26,78,151
314,Kyle O'Quinn,PF,25,NYK,37,0,425,70,139,0.504,1,11,0.091,69,128,0.539,0.507,30,39,0.769,44,96,140,43,15,21,40,65,171
315,Jahlil Okafor,C,20,PHI,41,37,1263,303,619,0.489,0,3,0,303,616,0.492,0.489,106,155,0.684,95,206,301,49,18,47,92,100,712
316,Victor Oladipo,SG,23,ORL,40,20,1220,201,495,0.406,55,154,0.357,146,341,0.428,0.462,93,112,0.83,21,170,191,161,50,24,88,93,550
317,Kelly Olynyk,C,24,BOS,45,8,937,172,374,0.46,61,139,0.439,111,235,0.472,0.541,48,71,0.676,51,146,197,71,41,29,57,114,453
318,Kelly Oubre,SF,20,WAS,36,9,484,57,140,0.407,21,57,0.368,36,83,0.434,0.482,24,35,0.686,18,73,91,11,15,5,20,63,159
319,Zaza Pachulia,C,31,DAL,43,43,1256,150,313,0.479,0,2,0,150,311,0.482,0.479,146,184,0.793,158,303,461,81,44,16,80,116,446
320,Kostas Papanikolaou,SF,25,DEN,26,6,294,24,66,0.364,10,32,0.313,14,34,0.412,0.439,9,14,0.643,8,32,40,16,13,5,21,24,67
321,Jabari Parker,PF,20,MIL,41,37,1146,195,400,0.488,0,6,0,195,394,0.495,0.488,77,98,0.786,61,127,188,59,31,18,42,71,467
322,Tony Parker,PG,33,SAS,41,41,1102,213,407,0.523,15,35,0.429,198,372,0.532,0.542,73,96,0.76,11,94,105,206,37,7,67,67,514
323,Chandler Parsons,SF,27,DAL,39,29,1057,174,362,0.481,51,131,0.389,123,231,0.532,0.551,47,79,0.595,14,145,159,97,21,14,53,66,446
324,Lamar Patterson,SG,24,ATL,30,0,375,26,73,0.356,11,45,0.244,15,28,0.536,0.432,16,22,0.727,4,45,49,37,7,2,20,43,79
325,Patrick Patterson,PF,26,TOR,45,0,1080,108,276,0.391,60,177,0.339,48,99,0.485,0.5,9,10,0.9,37,157,194,52,33,16,36,66,285
326,Chris Paul,PG,30,LAC,40,40,1296,270,592,0.456,62,157,0.395,208,435,0.478,0.508,149,169,0.882,24,132,156,385,82,7,113,113,751
327,Adreian Payne,PF,24,MIN,30,2,285,33,81,0.407,8,21,0.381,25,60,0.417,0.457,8,12,0.667,10,51,61,14,9,8,19,46,82
328,Cameron Payne,PG,21,OKC,31,0,360,67,150,0.447,26,62,0.419,41,88,0.466,0.533,6,8,0.75,4,48,52,58,23,4,19,41,166
329,Elfrid Payton,PG,21,ORL,40,39,1185,180,423,0.426,16,45,0.356,164,378,0.434,0.444,71,115,0.617,40,102,142,235,53,9,101,86,447
330,Nikola Pekovic,C,30,MIN,9,3,127,19,43,0.442,0,0,,19,43,0.442,0.442,15,18,0.833,5,11,16,7,0,0,8,20,53
331,Kendrick Perkins,C,31,NOP,9,2,83,13,16,0.813,0,0,,13,16,0.813,0.813,1,4,0.25,6,13,19,5,0,2,6,9,27
332,Paul Pierce,SF,38,LAC,42,16,737,81,234,0.346,47,148,0.318,34,86,0.395,0.447,31,39,0.795,9,111,120,40,20,9,29,77,240
333,Tibor Pleiss,C,26,UTA,11,0,78,11,25,0.44,0,2,0,11,23,0.478,0.44,2,2,1,6,9,15,2,1,2,8,19,24
334,Mason Plumlee,C,25,POR,47,47,1222,160,313,0.511,0,2,0,160,311,0.514,0.511,119,192,0.62,125,242,367,130,37,44,94,143,439
335,Miles Plumlee,C,27,MIL,26,1,200,25,43,0.581,0,0,,25,43,0.581,0.581,11,14,0.786,19,30,49,4,4,13,11,22,61
336,Otto Porter,SF,22,WAS,36,34,1155,178,382,0.466,43,134,0.321,135,248,0.544,0.522,55,71,0.775,50,154,204,75,59,12,42,89,454
337,Bobby Portis,PF,20,CHI,24,0,339,66,147,0.449,6,19,0.316,60,128,0.469,0.469,17,23,0.739,34,66,100,11,10,10,28,36,155
338,Kristaps Porzingis,PF,20,NYK,47,47,1328,240,563,0.426,52,152,0.342,188,411,0.457,0.472,126,148,0.851,96,269,365,56,36,92,81,137,658
339,Dwight Powell,PF,24,DAL,45,0,767,113,235,0.481,2,10,0.2,111,225,0.493,0.485,77,105,0.733,63,155,218,32,26,21,31,93,305
340,Norman Powell,SG,22,TOR,18,0,83,10,34,0.294,1,7,0.143,9,27,0.333,0.309,0,1,0,6,11,17,4,6,0,4,9,21
341,Phil Pressey,PG,24,PHI,14,0,170,21,55,0.382,4,13,0.308,17,42,0.405,0.418,9,18,0.5,0,23,23,46,11,1,19,14,55
342,Ronnie Price,PG,32,PHO,34,1,504,47,123,0.382,32,84,0.381,15,39,0.385,0.512,17,19,0.895,10,28,38,59,36,5,26,77,143
343,Pablo Prigioni,PG,38,LAC,25,1,347,22,54,0.407,11,35,0.314,11,19,0.579,0.509,2,2,1,16,30,46,52,30,0,22,33,57
344,Tayshaun Prince,SF,35,MIN,46,35,971,70,146,0.479,2,12,0.167,68,134,0.507,0.486,6,11,0.545,19,74,93,42,23,8,16,37,148
345,Julius Randle,PF,21,LAL,46,25,1229,191,473,0.404,5,20,0.25,186,453,0.411,0.409,102,150,0.68,102,340,442,75,30,21,80,138,489
346,Zach Randolph,PF,34,MEM,41,26,1179,237,492,0.482,1,6,0.167,236,486,0.486,0.483,94,125,0.752,123,211,334,60,24,8,58,81,569
347,J.J. Redick,SG,31,LAC,41,41,1141,226,465,0.486,112,229,0.489,114,236,0.483,0.606,111,127,0.874,5,64,69,64,20,2,43,70,675
348,Willie Reed,PF,25,BRK,26,0,267,47,80,0.588,0,0,,47,80,0.588,0.588,16,32,0.5,26,44,70,5,3,14,13,34,110
349,Josh Richardson,SG,22,MIA,21,1,260,14,53,0.264,5,24,0.208,9,29,0.31,0.311,11,16,0.688,4,21,25,19,8,5,12,34,44
350,Austin Rivers,SG,23,LAC,42,5,921,129,304,0.424,27,103,0.262,102,201,0.507,0.469,41,59,0.695,14,63,77,57,27,7,37,91,326
351,Andre Roberson,SG,24,OKC,45,45,978,91,184,0.495,17,62,0.274,74,122,0.607,0.541,22,36,0.611,50,99,149,36,40,30,28,81,221
352,Brian Roberts,PG,30,CHO,25,0,257,35,79,0.443,6,18,0.333,29,61,0.475,0.481,19,20,0.95,2,20,22,31,7,1,14,16,95
353,Nate Robinson,PG,31,NOP,2,1,23,0,1,0,0,1,0,0,0,,0,0,0,,0,0,0,4,1,0,0,5,0
354,Thomas Robinson,PF,24,BRK,40,0,392,58,119,0.487,0,0,,58,119,0.487,0.487,20,38,0.526,53,88,141,7,14,20,30,46,136
355,Glenn Robinson III,PF,22,IND,30,4,358,42,98,0.429,9,26,0.346,33,72,0.458,0.474,23,34,0.676,8,41,49,15,13,5,13,13,116
356,Rajon Rondo,PG,29,SAC,43,43,1509,210,468,0.449,30,91,0.33,180,377,0.477,0.481,51,91,0.56,54,228,282,508,74,8,166,96,501
357,Derrick Rose,PG,27,CHI,38,38,1218,239,589,0.406,23,87,0.264,216,502,0.43,0.425,80,101,0.792,20,99,119,172,22,11,99,56,581
358,Terrence Ross,SF,24,TOR,39,7,911,127,288,0.441,66,169,0.391,61,119,0.513,0.556,21,25,0.84,12,77,89,27,33,16,30,58,341
359,Terry Rozier,PG,21,BOS,18,0,106,12,49,0.245,2,12,0.167,10,37,0.27,0.265,3,3,1,8,11,19,11,0,0,8,11,29
360,Ricky Rubio,PG,25,MIN,40,40,1210,111,317,0.35,27,90,0.3,84,227,0.37,0.393,134,161,0.832,30,149,179,344,88,3,96,102,383
361,Damjan Rudez,SF,29,MIN,17,0,141,14,32,0.438,10,25,0.4,4,7,0.571,0.594,4,4,1,1,6,7,6,0,0,7,15,42
362,Brandon Rush,SG,30,GSW,36,23,582,72,155,0.465,43,92,0.467,29,63,0.46,0.603,7,12,0.583,14,83,97,31,13,9,19,28,194
363,D'Angelo Russell,PG,19,LAL,45,22,1214,217,520,0.417,70,214,0.327,147,306,0.48,0.485,47,70,0.671,28,136,164,150,53,7,108,71,551
364,Robert Sacre,C,26,LAL,15,0,195,18,44,0.409,0,0,,18,44,0.409,0.409,10,20,0.5,17,20,37,11,2,8,8,27,46
365,JaKarr Sampson,SF,22,PHI,44,18,676,84,192,0.438,6,31,0.194,78,161,0.484,0.453,61,96,0.635,29,98,127,30,11,16,50,91,235
366,Dennis Schroder,PG,22,ATL,44,6,944,181,433,0.418,46,141,0.326,135,292,0.462,0.471,71,89,0.798,19,104,123,209,47,5,93,72,479
367,Luis Scola,PF,35,TOR,45,45,1051,183,403,0.454,33,79,0.418,150,324,0.463,0.495,45,57,0.789,66,189,255,37,29,19,41,111,444
368,Mike Scott,PF,27,ATL,40,0,576,106,205,0.517,35,83,0.422,71,122,0.582,0.602,30,37,0.811,20,67,87,39,12,10,24,55,277
369,Thabo Sefolosha,SF,31,ATL,40,10,971,112,216,0.519,20,70,0.286,92,146,0.63,0.565,36,55,0.655,29,157,186,61,54,21,36,59,280
370,Kevin Seraphin,C,26,NYK,29,0,311,50,127,0.394,0,1,0,50,126,0.397,0.394,11,15,0.733,23,47,70,32,6,24,28,38,111
371,Ramon Sessions,PG,29,WAS,43,0,910,142,301,0.472,19,60,0.317,123,241,0.51,0.503,129,167,0.772,11,97,108,127,30,3,59,64,432
372,Iman Shumpert,SG,25,CLE,21,0,509,57,142,0.401,23,66,0.348,34,76,0.447,0.482,11,15,0.733,10,49,59,31,21,9,21,45,148
373,Jonathon Simmons,SG,26,SAS,31,0,426,69,130,0.531,12,27,0.444,57,103,0.553,0.577,39,51,0.765,6,44,50,37,14,2,33,61,189
374,Kyle Singler,SF,27,OKC,36,1,434,38,104,0.365,16,51,0.314,22,53,0.415,0.442,15,23,0.652,18,42,60,8,15,5,17,57,107
375,Donald Sloan,PG,28,BRK,26,9,458,49,113,0.434,13,30,0.433,36,83,0.434,0.491,23,33,0.697,11,58,69,105,10,1,37,24,134
376,Marcus Smart,PG,21,BOS,25,8,677,80,229,0.349,22,98,0.224,58,131,0.443,0.397,47,67,0.701,35,77,112,79,42,9,32,76,229
377,Ish Smith,PG,27,PHI,15,15,466,100,249,0.402,7,23,0.304,93,226,0.412,0.416,35,47,0.745,9,42,51,123,21,4,42,31,242
378,J.R. Smith,SG,30,CLE,39,39,1173,179,437,0.41,93,243,0.383,86,194,0.443,0.516,29,48,0.604,24,87,111,60,42,15,31,109,480
379,Jason Smith,C,29,ORL,39,0,576,105,207,0.507,2,10,0.2,103,197,0.523,0.512,22,24,0.917,21,76,97,27,13,26,29,80,234
380,Josh Smith,PF,30,TOT,35,1,531,78,215,0.363,20,72,0.278,58,143,0.406,0.409,28,48,0.583,37,100,137,53,22,39,46,73,204
380,Josh Smith,PF,30,LAC,32,1,459,69,180,0.383,18,58,0.31,51,122,0.418,0.433,25,42,0.595,33,92,125,42,18,34,41,62,181
380,Josh Smith,PF,30,HOU,3,0,72,9,35,0.257,2,14,0.143,7,21,0.333,0.286,3,6,0.5,4,8,12,11,4,5,5,11,23
381,Russ Smith,PG,24,MEM,15,0,66,7,22,0.318,1,5,0.2,6,17,0.353,0.341,8,13,0.615,1,8,9,11,5,1,7,5,23
382,Tony Snell,SF,24,CHI,42,27,925,89,247,0.36,43,121,0.355,46,126,0.365,0.447,22,24,0.917,11,135,146,42,13,12,40,65,243
383,Marreese Speights,PF,28,GSW,36,0,387,77,208,0.37,5,14,0.357,72,194,0.371,0.382,44,56,0.786,38,75,113,24,8,13,35,58,203
384,Tiago Splitter,C,31,ATL,33,2,533,76,146,0.521,0,2,0,76,144,0.528,0.521,34,42,0.81,41,67,108,27,17,12,23,67,186
385,Nik Stauskas,SG,22,PHI,40,19,951,101,283,0.357,56,177,0.316,45,106,0.425,0.456,31,46,0.674,11,84,95,74,24,15,47,54,289
386,Lance Stephenson,SF,25,LAC,36,10,559,58,132,0.439,14,40,0.35,44,92,0.478,0.492,16,23,0.696,17,69,86,52,19,2,40,63,146
387,Jarnell Stokes,C,22,MIA,2,0,7,2,4,0.5,0,0,,2,4,0.5,0.5,0,0,,0,1,1,0,0,0,0,0,4
388,Amar'e Stoudemire,C,33,MIA,18,3,225,31,61,0.508,0,0,,31,61,0.508,0.508,17,23,0.739,18,39,57,12,6,8,16,19,79
389,Rodney Stuckey,PG,29,IND,33,0,826,119,290,0.41,10,48,0.208,109,242,0.45,0.428,77,93,0.828,15,98,113,87,25,6,48,45,325
390,Jared Sullinger,PF,23,BOS,45,37,1076,181,432,0.419,19,71,0.268,162,361,0.449,0.441,59,93,0.634,113,278,391,100,42,29,60,122,440
391,Walter Tavares,C,23,ATL,8,0,58,8,15,0.533,0,0,,8,15,0.533,0.533,3,8,0.375,6,9,15,2,1,5,4,5,19
392,Jeff Teague,PG,27,ATL,43,42,1219,212,513,0.413,46,122,0.377,166,391,0.425,0.458,145,172,0.843,21,91,112,239,55,14,116,89,615
393,Mirza Teletovic,PF,30,PHO,45,0,810,151,352,0.429,94,225,0.418,57,127,0.449,0.563,41,56,0.732,25,116,141,47,15,12,38,62,437
394,Garrett Temple,SF,29,WAS,41,24,1011,114,285,0.4,46,138,0.333,68,147,0.463,0.481,59,80,0.738,18,88,106,74,37,11,28,88,333
395,Jason Terry,SG,38,HOU,39,7,673,83,191,0.435,50,136,0.368,33,55,0.6,0.565,19,24,0.792,3,34,37,54,29,6,28,56,235
396,Isaiah Thomas,PG,26,BOS,46,43,1490,323,760,0.425,94,270,0.348,229,490,0.467,0.487,260,291,0.893,25,113,138,307,54,3,125,88,1000
397,Lance Thomas,SF,27,NYK,44,4,958,137,292,0.469,35,84,0.417,102,208,0.49,0.529,82,93,0.882,28,67,95,41,19,6,46,79,391
398,Hollis Thompson,SG,24,PHI,44,2,1178,137,338,0.405,77,195,0.395,60,143,0.42,0.519,30,46,0.652,26,122,148,50,18,14,52,111,381
399,Jason Thompson,C,29,GSW,22,1,150,16,37,0.432,0,0,,16,37,0.432,0.432,17,26,0.654,9,41,50,17,3,7,6,34,49
400,Klay Thompson,SG,25,GSW,43,43,1408,315,686,0.459,133,316,0.421,182,370,0.492,0.556,111,134,0.828,19,147,166,102,20,32,80,85,874
401,Tristan Thompson,PF,24,CLE,43,13,1177,131,232,0.565,0,0,,131,232,0.565,0.565,75,128,0.586,143,262,405,32,14,16,31,108,337
402,Marcus Thornton,SG,28,HOU,40,6,768,156,380,0.411,66,185,0.357,90,195,0.462,0.497,42,48,0.875,25,72,97,54,30,1,35,62,420
403,Anthony Tolliver,PF,30,DET,44,0,850,79,204,0.387,61,162,0.377,18,42,0.429,0.537,21,33,0.636,24,124,148,37,18,12,13,52,240
404,Karl-Anthony Towns,C,20,MIN,46,46,1350,307,576,0.533,14,37,0.378,293,539,0.544,0.545,111,130,0.854,121,326,447,63,31,81,96,143,739
405,P.J. Tucker,SF,30,PHO,46,44,1310,112,279,0.401,36,102,0.353,76,177,0.429,0.466,47,64,0.734,76,183,259,81,54,12,53,105,307
406,Evan Turner,SG,27,BOS,46,4,1236,172,399,0.431,9,61,0.148,163,338,0.482,0.442,74,89,0.831,28,180,208,184,41,13,97,73,427
407,Myles Turner,C,19,IND,23,0,387,84,148,0.568,0,2,0,84,146,0.575,0.568,37,55,0.673,20,73,93,7,6,29,14,47,205
408,Beno Udrih,PG,33,MIA,26,5,420,42,97,0.433,9,22,0.409,33,75,0.44,0.479,9,10,0.9,2,44,46,67,8,0,24,29,102
409,Jonas Valanciunas,C,23,TOR,28,27,750,136,245,0.555,0,0,,136,245,0.555,0.555,76,102,0.745,88,173,261,25,11,35,47,71,348
410,Anderson Varejao,C,33,CLE,26,0,237,23,57,0.404,0,1,0,23,56,0.411,0.404,13,17,0.765,17,53,70,17,7,3,12,26,59
411,Greivis Vasquez,PG,29,MIL,16,0,361,39,112,0.348,14,54,0.259,25,58,0.431,0.411,22,25,0.88,4,33,37,71,7,0,30,33,114
412,Rashad Vaughn,SG,19,MIL,39,0,435,31,106,0.292,19,54,0.352,12,52,0.231,0.382,8,9,0.889,8,39,47,15,11,6,15,32,89
413,Charlie Villanueva,PF,31,DAL,38,4,457,88,231,0.381,28,118,0.237,60,113,0.531,0.442,14,16,0.875,13,87,100,16,12,11,20,51,218
414,Noah Vonleh,PF,20,POR,47,36,750,71,164,0.433,4,23,0.174,67,141,0.475,0.445,26,32,0.813,61,129,190,25,23,13,27,94,172
415,Nikola Vucevic,C,25,ORL,41,40,1288,319,632,0.505,1,6,0.167,318,626,0.508,0.506,47,63,0.746,119,241,360,112,33,45,73,104,686
416,Sasha Vujacic,SG,31,NYK,30,8,353,31,105,0.295,12,51,0.235,19,54,0.352,0.352,10,14,0.714,10,42,52,35,14,2,21,32,84
417,Dwyane Wade,SG,34,MIA,43,42,1300,314,683,0.46,7,31,0.226,307,652,0.471,0.465,167,217,0.77,53,123,176,199,41,21,112,61,802
418,Dion Waiters,SG,24,OKC,47,3,1284,174,433,0.402,47,133,0.353,127,300,0.423,0.456,66,91,0.725,23,112,135,93,43,7,75,87,461
419,Kemba Walker,PG,25,CHO,45,45,1626,319,750,0.425,82,225,0.364,237,525,0.451,0.48,207,240,0.863,35,155,190,229,81,29,97,65,927
420,John Wall,PG,25,WAS,43,43,1533,316,737,0.429,61,178,0.343,255,559,0.456,0.47,150,192,0.781,28,150,178,420,89,32,188,90,843
421,T.J. Warren,SF,22,PHO,45,4,1024,211,424,0.498,27,68,0.397,184,356,0.517,0.529,43,60,0.717,56,86,142,41,36,16,32,90,492
422,C.J. Watson,PG,31,ORL,8,0,156,14,38,0.368,5,16,0.313,9,22,0.409,0.434,5,7,0.714,4,12,16,25,8,0,6,10,38
423,Sonny Weems,SG,29,PHO,24,0,261,21,51,0.412,8,20,0.4,13,31,0.419,0.49,7,11,0.636,5,24,29,31,7,0,25,27,57
424,David West,PF,35,SAS,44,10,736,132,232,0.569,1,3,0.333,131,229,0.572,0.571,32,44,0.727,35,143,178,76,25,26,39,77,297
425,Russell Westbrook,PG,27,OKC,47,47,1603,401,882,0.455,54,192,0.281,347,690,0.503,0.485,275,339,0.811,80,260,340,456,116,12,199,114,1131
426,Hassan Whiteside,C,26,MIA,41,40,1184,211,344,0.613,0,0,,211,344,0.613,0.613,83,153,0.542,128,331,459,14,23,158,85,99,505
427,Shayne Whittington,PF,24,IND,2,0,7,1,1,1,0,0,,1,1,1,1,0,0,,0,1,1,2,0,1,2,2,2
428,Andrew Wiggins,SG,20,MIN,45,45,1575,333,744,0.448,27,110,0.245,306,634,0.483,0.466,244,329,0.742,70,102,172,82,38,25,101,98,937
429,C.J. Wilcox,SG,25,LAC,5,0,17,2,6,0.333,0,0,,2,6,0.333,0.333,0,0,,0,1,1,2,0,0,0,1,4
430,Deron Williams,PG,31,DAL,39,37,1267,195,464,0.42,56,160,0.35,139,304,0.457,0.481,103,115,0.896,11,109,120,215,38,10,96,90,549
431,Derrick Williams,PF,24,NYK,46,0,789,142,321,0.442,22,90,0.244,120,231,0.519,0.477,126,167,0.754,25,145,170,42,20,6,31,44,432
432,Elliot Williams,PG,26,MEM,5,0,45,2,10,0.2,1,4,0.25,1,6,0.167,0.25,3,4,0.75,1,3,4,4,0,0,1,2,8
433,Lou Williams,SG,29,LAL,45,27,1320,198,489,0.405,71,214,0.332,127,275,0.462,0.478,231,277,0.834,19,103,122,118,44,14,71,80,698
434,Marvin Williams,PF,29,CHO,45,45,1328,152,369,0.412,70,193,0.363,82,176,0.466,0.507,64,70,0.914,71,228,299,65,26,47,33,75,438
435,Mo Williams,PG,33,CLE,28,14,622,110,243,0.453,27,80,0.338,83,163,0.509,0.508,36,40,0.9,4,59,63,91,11,5,50,50,283
436,Justise Winslow,SF,19,MIA,43,3,1178,93,228,0.408,22,82,0.268,71,146,0.486,0.456,35,52,0.673,35,171,206,59,31,15,58,97,243
437,Jeff Withey,C,25,UTA,36,9,551,71,130,0.546,0,0,,71,130,0.546,0.546,38,53,0.717,48,100,148,16,19,48,26,59,180
438,Christian Wood,PF,20,PHI,14,0,114,19,43,0.442,4,9,0.444,15,34,0.441,0.488,9,13,0.692,10,22,32,3,5,5,2,9,51
439,Metta World Peace,SF,36,LAL,19,3,332,30,96,0.313,17,46,0.37,13,50,0.26,0.401,16,23,0.696,10,38,48,17,12,9,8,35,93
440,Brandan Wright,PF,28,MEM,7,0,120,18,30,0.6,0,0,,18,30,0.6,0.6,10,18,0.556,6,18,24,4,1,10,4,9,46
441,Delon Wright,PG,23,TOR,11,0,31,2,10,0.2,0,1,0,2,9,0.222,0.2,3,6,0.5,1,5,6,4,0,0,3,2,7
442,Tony Wroten,PG,22,PHI,8,3,144,22,65,0.338,3,17,0.176,19,48,0.396,0.362,20,37,0.541,2,19,21,20,3,0,29,11,67
443,James Young,SG,20,BOS,18,0,155,10,29,0.345,5,21,0.238,5,8,0.625,0.431,1,4,0.25,3,17,20,7,4,1,3,13,26
444,Joseph Young,PG,23,IND,20,0,167,30,74,0.405,3,15,0.2,27,59,0.458,0.426,15,19,0.789,3,17,20,33,9,0,16,13,78
445,Nick Young,SG,30,LAL,37,0,699,96,264,0.364,58,165,0.352,38,99,0.384,0.473,28,35,0.8,9,52,61,20,19,5,20,29,278
446,Thaddeus Young,PF,27,BRK,46,46,1486,315,617,0.511,5,23,0.217,310,594,0.522,0.515,62,106,0.585,122,290,412,70,68,18,84,115,697
447,Cody Zeller,C,23,CHO,40,27,991,128,258,0.496,0,9,0,128,249,0.514,0.496,103,140,0.736,73,163,236,35,35,28,37,119,359
448,Tyler Zeller,C,26,BOS,29,3,264,54,114,0.474,0,0,,54,114,0.474,0.474,26,38,0.684,24,45,69,10,6,4,22,43,134
